00,00,00,00,00,00,00,00,00,00,00,00,00,00,00,00,00,00,00,
00,00,00,00,00,00,00,00,00,00,00,00,00,00,00,00,00,00,00,
00,00,00,00,00,00,00,00,00,00,00,00,00,00,00,59,00,59,00,
00,00,00,00,00,00,00,00,00,00,00,00,00,00,00,69,00,59,00,
04,06,03,21,04,78,05,39,78,06,00,00,00,00,04,05,05,05,05,
24,26,02,21,24,25,25,25,25,26,68,68,68,68,24,25,25,25,25,
03,03,03,01,03,03,03,03,77,03,07,03,03,03,03,03,07,03,03,
03,13,03,41,22,22,22,32,32,22,41,32,32,32,33,03,03,03,03,
04,05,05,05,06,02,51,12,51,03,02,51,51,51,51,02,12,04,05,
14,15,15,15,16,51,51,51,51,51,02,51,51,51,03,02,02,14,15,
14,15,15,15,16,12,51,51,51,12,51,51,02,51,51,51,02,14,15,
14,15,15,15,17,35,35,35,35,35,35,35,35,35,36,03,02,14,15,